test
15 11
1 7
1 1 1 1 1 1 1 1 1 1 1 1 1 1 1
1 0 0 0 0 0 0 1 0 0 0 0 0 0 1
1 0 0 0 0 0 0 1 0 0 0 0 0 3 1
1 0 0 0 0 0 0 1 0 0 0 0 0 3 1
1 0 0 0 0 0 0 1 0 0 0 0 0 3 1
1 2 0 0 0 0 0 0 0 0 0 0 0 3 1
1 0 0 0 0 0 0 1 0 0 0 0 0 3 1
1 0 0 0 0 0 0 1 0 0 0 0 0 3 1
1 0 0 0 0 0 0 1 0 0 0 0 0 3 1
1 0 0 0 0 0 0 1 0 0 0 0 0 0 1
1 1 1 1 1 1 1 1 1 1 1 1 1 1 1

Format :
name
w h
st ex

0 = air
1 = mur
2 = entrée
3 = sortie
