simple_porte
15 11
7 7
1 1 1 1 1 1 1 1 1 1 1 1 1 1 1
1 0 0 0 0 0 0 1 0 0 0 0 0 0 1
1 2 0 0 0 0 0 1 0 0 0 0 0 3 1
1 2 0 0 0 0 0 1 0 0 0 0 0 3 1
1 2 0 0 0 0 0 1 0 0 0 0 0 3 1
1 2 0 0 0 0 0 0 0 0 0 0 0 3 1
1 2 0 0 0 0 0 1 0 0 0 0 0 3 1
1 2 0 0 0 0 0 1 0 0 0 0 0 3 1
1 2 0 0 0 0 0 1 0 0 0 0 0 3 1
1 0 0 0 0 0 0 1 0 0 0 0 0 0 1
1 1 1 1 1 1 1 1 1 1 1 1 1 1 1
