3simples_portes
15 11
7 3
1 1 1 1 1 1 1 1 1 1 1 1 1 1 1
1 0 0 0 0 0 0 0 0 1 0 0 0 0 1
1 2 0 0 0 0 0 0 0 1 0 0 0 0 1
1 2 0 0 0 0 0 0 0 1 0 0 0 0 1
1 2 0 0 0 0 0 0 0 0 0 0 0 3 1
1 2 0 0 0 0 0 0 0 0 0 0 0 3 1
1 2 0 0 0 0 0 0 0 0 0 0 0 3 1
1 2 0 0 0 0 0 0 0 1 0 0 0 0 1
1 2 0 0 0 0 0 0 0 1 0 0 0 0 1
1 0 0 0 0 0 0 0 0 1 0 0 0 0 1
1 1 1 1 1 1 1 1 1 1 1 1 1 1 1
